R  640 480
NO ./img/wood.xpm
SO ./img/redbrick.xpm
WE ./img/eagle.xpm
EA ./img/colorstone.xpm
S ./img/barrel.xpm
F 112,128,144
C 169,169,169
11111111111111111111111111111
10000000000000000000000000001
10110000000000000020000000001
100100N0000000000000000000001
11111111100000000111000000001
10000000000000000111011111111
11110111111111000000000010001
11110111111111000001010010001
11000000110101000000000010001
10002000000000000000000010001
10000000000000000001010010001
11000001110101011111011110011
11110111 1110101 101111010001
11111111 1111111 111111111111