R 640    480
NO ./img/c.xpm
SO ./img/eagle.xpm
EA ./img/redbrick.xpm
WE ./img/wood.xpm
S ./img/barrel.xpm
C 120,200,200
F 45,50,30
        1111111111111111111111111
        1000000000110000000000001
        1011000001110000002000001
        1001000000000000000000001
111111111011000001110000000000001
100000000011000001110111111111111
11110111111111011100000000001
11110111111111011101010010001
11000000110101011100000010001
10002000000000001100000010001
10000000000000001101010010001
1100000111010101111101111000111
1111N111 1110101 101111010001
11111111 1111111 111111111111
